[	PUNC
مسعود	Ne
بهنود	N
]	PUNC
:	PUNC
بخش	Ne
دوم	NUM
بررسی	Ne
روزنامه‌ها	N
را	POSTP
شروع	N
کنیم	V
از	P
روزنامه	Ne
جمهوری‌اسلامی	N
،	PUNC
دفاع	Ne
بد	AJ
و	CONJ
بعد	P
از	P
آن	PRO
برسیم	V
به	P
شهروند	N
،	PUNC
وقتی	CONJ
قانون‌گذاری	Ne
سیاسی	AJ
می‌شود	V
و	CONJ
سرانجام	ADV
ابتکار	N
که	CONJ
می‌پرسد	V
این	DET
سرمایه‌ها	N
از	P
کجا	ADV
آمده است	V
؟	PUNC

روزنامه	Ne
جمهوری‌اسلامی	N
در	P
سرمقاله	Ne
خودش	PRO
نوشته	V
:	PUNC
هنوز	ADV
مجادلات	Ne
مربوط	AJ
به	P
اظهارنظر	Ne
آقای	Ne
علم‌الهدی	N
امام	Ne
جمعه	Ne
مشهد	N
در	P
روزنامه‌ها	N
هست	V
و	CONJ
تمام	DETe
نشده	V
بود	V
که	CONJ
آیت‌الله	N
مصباح	Ne
یزدی	N
وارد	Pe
صحبت	N
شد	V
و	CONJ
مطلب	Ne
جدیدی	AJ
گفت	V
که	CONJ
بار	Ne
دیگر	PRO
رسانه‌ها	N
را	POSTP
درگیر	AJe
خودش	PRO
کرده است	V
.	PUNC
او	PRO
گفته	V
،	PUNC
خدا	N
را	POSTP
شاهد	N
می‌گیرم	V
جامعه	Ne
ما	PRO
لیاقت	Ne
چنین	CL
رهبری	N
را	POSTP
ندارد	V
.	PUNC
منظور	N
در	P
روزنامه	Ne
شهروند	N
طرحی	N
است	V
که	CONJ
مجلس	N
تهیه	N
کرده بود	V
برای	Pe
حمایت	N
از	P
آمران	N
به	P
معروف	N
و	CONJ
ناهیان	N
از	P
منکر	N
.	PUNC
مصطفی	N
عابدی	N
در	P
شهروند	N
اشاره	N
کرده	V
که	CONJ
مهم‌ترین	AJ
قوانین	Ne
هر	DET
کشوری	N
قانون	Ne
مجازات	N
است	V
ولی	CONJ
همین	DET
قانون	N
مجازات	N
در	P
کشور	Ne
ما	PRO
چند	DET
بار	N
به	P
صورت	Ne
آزمایشی	AJ
تصویب	N
شده	V
ولی	CONJ
اجرا	N
نشده	V
است	V
.	PUNC
علی	N
محقق	N
در	P
ابتکار	N
اشاره	N
کرده	V
به	P
سر	N
و	CONJ
صدایی	N
که	CONJ
در	P
مورد	Ne
پدیده	Ne
شاندیز	N
برپا	AJ
است	V
و	CONJ
نوشته	N
در	P
نیمه	Ne
دوم	NUMe
دهه	Ne
هشتاد	NUM
هولدینگ	Ne
بزرگ	AJe
توسعه	Ne
سرمایه‌گذاری‌های	Ne
یک	NUM
موسسه	N
و	CONJ
تیم	Ne
فوتبال	Ne
لیگ	Ne
برتر	AJe
آنها	PRO
یعنی	CONJ
داماش	N
چشم	Ne
همگان	PRO
را	POSTP
خیره	AJ
می‌کرد	V
.	PUNC
بی‌این	V
که	CONJ
کسی	N
از	P
عقبه	N
و	CONJ
تاریخچه	Ne
این	DET
شرکت	N
و	CONJ
چگونگی	Ne
اوج‌گیری‌اش	N
خبر	N
داشته باشد	V
.	PUNC
ولی	CONJ
افشای	Ne
پرونده	Ne
فساد	Ne
سه	NUM
هزار	NUM
میلیاردی	RESe
همه	DET
چیز	N
را	POSTP
مشخص	AJ
کرد	V
.	PUNC
